150
0
13
5
3
0
3
1
+F+C+F+C+
FXFXTXTXT
+F+C+T+F+
TXFXFXFXF
+F+F+T+F+
