100
0
84
10
9
2
1
1
+F+F+X+F+T+F+F+X+X+
FXXXFXXXFXFXFXXXFXF
+F+F+F+F+X+F+F+F+F+
XXXXCXXXFXFXXXFXXXX
+F+F+T+X+T+F+T+F+X+
FXXXXXXXTXXXFXXXFXX
+F+F+F+X+F+X+T+F+F+
TXXXXXXXFXFXXXFXXXT
+F+X+F+X+X+F+T+F+F+
FXFXXXFXXXFXFXXXFXF
+F+T+F+X+X+F+F+F+X+
FXXXXXFXFXXXXXXXXXC
+F+X+X+F+F+F+F+T+F+
TXXXFXFXXXFXXXFXXXF
+F+F+F+F+F+X+F+X+F+
FXFXXXXXTXXXFXXXFXF
+X+X+F+F+F+X+X+F+X+
